11111111111111111111111111111111
10000000000000000000000000000001
10000000000000000000010000000001
10000000001000000000000000000001
10001000010000000000010000000001
10001000000000000000000000000001
100010000000000000N0010010000001
10000000000000000000000000000001
10000000000000000000000000000001
10000000000000000000000000000001
10000000000000000000000000000001
10000000000000000000000000000001
10000000000000000000000000000001
10000000000000000000000000000001
10000000000000000000000000000001
11111111111111111111111111111111