NO textures/wall_N.xpm       
SO textures/wall_E.xpm
WE textures/wall_W.xpm
EA textures/wall_S.xpm

F 0,0,0
C 0,0,0


11111111111111111111111111
10000000000000000000000001
10000000000000000000000001
10000000000000000000000001
10000000000000000000000001
10000000000000000000000001
10000000000000000000000001
10000000000000000000000001
10000000000010000000000001
100000000000N0000000000001
11111111111111111111111111